uAD.inc -> FireDAC.inc
uADVer.inc -> FireDAC.Ver.inc
uADEnv.inc -> FireDAC.Env.inc

uADDcl.dcr -> FireDAC.Dcl.Glyph.dcr
uADDcl.lrs -> FireDAC.Dcl.Glyph.lrs
uADDcl.rc -> FireDAC.Dcl.Glyph.rc
uADSplash.rc -> FireDAC.Dcl.Splash.rc
uADSplash.res -> FireDAC.Dcl.Splash.res
uADCompReg -> FireDAC.Dcl.Reg

uADCompADOUDLImport -> FireDAC.Import.ADO
uADCompBDEAliasImport -> FireDAC.Import.BDE

uADCompClient -> FireDAC.Comp.Client
uADCompDataMove -> FireDAC.Comp.DataMove
uADCompDataSet -> FireDAC.Comp.DataSet
uADCompGUIx -> FireDAC.Comp.UI
uADCompScript -> FireDAC.Comp.Script
uADCompScriptCommands -> FireDAC.Comp.ScriptCommands
uADCompSPGen -> FireDAC.Comp.SPGen

uADDAptColumn -> FireDAC.DApt.Column
uADDAptIntf -> FireDAC.DApt.Intf
uADDAptManager -> FireDAC.DApt

uADDatSManager -> FireDAC.DatS

uADGUIxIntf -> FireDAC.UI.Intf
uADGUIxManager -> FireDAC.UI

uADMoniBase -> FireDAC.Moni.Base
uADMoniCustom -> FireDAC.Moni.Custom
uADMoniFlatFile -> FireDAC.Moni.FlatFile
uADMoniRemoteBase -> FireDAC.Moni.RemoteBase
uADMoniRemoteClient -> FireDAC.Moni.RemoteClient
uADMoniRemoteServer -> FireDAC.Moni.RemoteServer
uADMoniIndyBase -> FireDAC.Moni.IndyBase
uADMoniIndyClient -> FireDAC.Moni.IndyClient
uADMoniIndyServer -> FireDAC.Moni.IndyServer

uADStanAsync -> FireDAC.Stan.Async
uADStanCipher -> FireDAC.Stan.Cipher
uADStanConst -> FireDAC.Stan.Const
uADStanDef -> FireDAC.Stan.Def
uADStanError -> FireDAC.Stan.Error
uADStanExpr -> FireDAC.Stan.Expr
uADStanExprFuncs -> FireDAC.Stan.ExprFuncs
uADStanFactory -> FireDAC.Stan.Factory
uADStanIntf -> FireDAC.Stan.Intf
uADStanOption -> FireDAC.Stan.Option
uADStanParam -> FireDAC.Stan.Param
uADStanPool -> FireDAC.Stan.Pool
uADStanResStrs -> FireDAC.Stan.ResStrs
uADStanSQLTimeInt -> FireDAC.Stan.SQLTimeInt
uADStanStorage -> FireDAC.Stan.Storage
uADStanTracer -> FireDAC.Stan.Tracer
uADStanUtil -> FireDAC.Stan.Util
uADPhysStatic -> FireDAC.Stan.CRTL

uADGUIxConsoleScript -> FireDAC.ConsoleUI.Script
uADGUIxConsoleWait -> FireDAC.ConsoleUI.Wait

uADGUIxFMXfAsync.fmx -> FireDAC.FMXUI.Async.fmx
uADGUIxFMXfAsync.lfm -> FireDAC.FMXUI.Async.lfm
uADGUIxFMXfAsync -> FireDAC.FMXUI.Async
uADGUIxFMXfError.fmx -> FireDAC.FMXUI.Error.fmx
uADGUIxFMXfError.lfm -> FireDAC.FMXUI.Error.lfm
uADGUIxFMXfError -> FireDAC.FMXUI.Error
uADGUIxFMXfLogin.fmx -> FireDAC.FMXUI.Login.fmx
uADGUIxFMXfLogin.lfm -> FireDAC.FMXUI.Login.lfm
uADGUIxFMXfLogin -> FireDAC.FMXUI.Login
uADGUIxFMXfOptsBase.fmx -> FireDAC.FMXUI.OptsBase.fmx
uADGUIxFMXfOptsBase.lfm -> FireDAC.FMXUI.OptsBase.lfm
uADGUIxFMXfOptsBase -> FireDAC.FMXUI.OptsBase
uADGUIxFMXfScript.fmx -> FireDAC.FMXUI.Script.fmx
uADGUIxFMXfScript.lfm -> FireDAC.FMXUI.Script.lfm
uADGUIxFMXfScript -> FireDAC.FMXUI.Script
uADGUIxFMXWait -> FireDAC.FMXUI.Wait

uADGUIxFormsControls -> FireDAC.VCLUI.Controls
uADGUIxFormsfAbout.dfm -> FireDAC.VCLUI.About.dfm
uADGUIxFormsfAbout.lfm -> FireDAC.VCLUI.About.lfm
uADGUIxFormsfAbout.lrs -> FireDAC.VCLUI.About.lrs
uADGUIxFormsfAbout -> FireDAC.VCLUI.About
uADGUIxFormsfAsync.dfm -> FireDAC.VCLUI.Async.dfm
uADGUIxFormsfAsync.lfm -> FireDAC.VCLUI.Async.lfm
uADGUIxFormsfAsync.lrs -> FireDAC.VCLUI.Async.lrs
uADGUIxFormsfAsync -> FireDAC.VCLUI.Async
uADGUIxFormsfConnEdit.dfm -> FireDAC.VCLUI.ConnEdit.dfm
uADGUIxFormsfConnEdit.lfm -> FireDAC.VCLUI.ConnEdit.lfm
uADGUIxFormsfConnEdit.lrs -> FireDAC.VCLUI.ConnEdit.lrs
uADGUIxFormsfConnEdit -> FireDAC.VCLUI.ConnEdit
uADGUIxFormsfDesignTimeOptions.dfm -> FireDAC.VCLUI.DesignTimeOptions.dfm
uADGUIxFormsfDesignTimeOptions.lfm -> FireDAC.VCLUI.DesignTimeOptions.lfm
uADGUIxFormsfDesignTimeOptions.lrs -> FireDAC.VCLUI.DesignTimeOptions.lrs
uADGUIxFormsfDesignTimeOptions -> FireDAC.VCLUI.DesignTimeOptions
uADGUIxFormsfError.dfm -> FireDAC.VCLUI.Error.dfm
uADGUIxFormsfError.lfm -> FireDAC.VCLUI.Error.lfm
uADGUIxFormsfError.lrs -> FireDAC.VCLUI.Error.lrs
uADGUIxFormsfError -> FireDAC.VCLUI.Error
uADGUIxFormsfFetchOptions.dfm -> FireDAC.VCLUI.FetchOptions.dfm
uADGUIxFormsfFetchOptions.lfm -> FireDAC.VCLUI.FetchOptions.lfm
uADGUIxFormsfFetchOptions.lrs -> FireDAC.VCLUI.FetchOptions.lrs
uADGUIxFormsfFetchOptions -> FireDAC.VCLUI.FetchOptions
uADGUIxFormsfFields.dfm -> FireDAC.VCLUI.Fields.dfm
uADGUIxFormsfFields.lfm -> FireDAC.VCLUI.Fields.lfm
uADGUIxFormsfFields.lrs -> FireDAC.VCLUI.Fields.lrs
uADGUIxFormsfFields -> FireDAC.VCLUI.Fields
uADGUIxFormsfFormatOptions.dfm -> FireDAC.VCLUI.FormatOptions.dfm
uADGUIxFormsfFormatOptions.lfm -> FireDAC.VCLUI.FormatOptions.lfm
uADGUIxFormsfFormatOptions.lrs -> FireDAC.VCLUI.FormatOptions.lrs
uADGUIxFormsfFormatOptions -> FireDAC.VCLUI.FormatOptions
uADGUIxFormsfLogin.dfm -> FireDAC.VCLUI.Login.dfm
uADGUIxFormsfLogin.lfm -> FireDAC.VCLUI.Login.lfm
uADGUIxFormsfLogin.lrs -> FireDAC.VCLUI.Login.lrs
uADGUIxFormsfLogin -> FireDAC.VCLUI.Login
uADGUIxFormsfOptsBase.dfm -> FireDAC.VCLUI.OptsBase.dfm
uADGUIxFormsfOptsBase.lfm -> FireDAC.VCLUI.OptsBase.lfm
uADGUIxFormsfOptsBase.lrs -> FireDAC.VCLUI.OptsBase.lrs
uADGUIxFormsfOptsBase -> FireDAC.VCLUI.OptsBase
uADGUIxFormsfQEdit.dfm -> FireDAC.VCLUI.QEdit.dfm
uADGUIxFormsfQEdit.lfm -> FireDAC.VCLUI.QEdit.lfm
uADGUIxFormsfQEdit.lrs -> FireDAC.VCLUI.QEdit.lrs
uADGUIxFormsfQEdit -> FireDAC.VCLUI.QEdit
uADGUIxFormsfResourceOptions.dfm -> FireDAC.VCLUI.ResourceOptions.dfm
uADGUIxFormsfResourceOptions.lfm -> FireDAC.VCLUI.ResourceOptions.lfm
uADGUIxFormsfResourceOptions.lrs -> FireDAC.VCLUI.ResourceOptions.lrs
uADGUIxFormsfResourceOptions -> FireDAC.VCLUI.ResourceOptions
uADGUIxFormsfScript.dfm -> FireDAC.VCLUI.Script.dfm
uADGUIxFormsfScript.lfm -> FireDAC.VCLUI.Script.lfm
uADGUIxFormsfScript.lrs -> FireDAC.VCLUI.Script.lrs
uADGUIxFormsfScript -> FireDAC.VCLUI.Script
uADGUIxFormsfSPGen.dfm -> FireDAC.VCLUI.SPGen.dfm
uADGUIxFormsfSPGen -> FireDAC.VCLUI.SPGen
uADGUIxFormsfUpdateOptions.dfm -> FireDAC.VCLUI.UpdateOptions.dfm
uADGUIxFormsfUpdateOptions.lfm -> FireDAC.VCLUI.UpdateOptions.lfm
uADGUIxFormsfUpdateOptions.lrs -> FireDAC.VCLUI.UpdateOptions.lrs
uADGUIxFormsfUpdateOptions -> FireDAC.VCLUI.UpdateOptions
uADGUIxFormsfUSEdit.dfm -> FireDAC.VCLUI.USEdit.dfm
uADGUIxFormsfUSEdit.lfm -> FireDAC.VCLUI.USEdit.lfm
uADGUIxFormsfUSEdit.lrs -> FireDAC.VCLUI.USEdit.lrs
uADGUIxFormsfUSEdit -> FireDAC.VCLUI.USEdit
uADGUIxFormsMemo -> FireDAC.VCLUI.Memo
uADGUIxFormsPanelTreeButton.res -> FireDAC.VCLUI.PanelTreeButton.res
uADGUIxFormsWait -> FireDAC.VCLUI.Wait

uADPhysADS -> FireDAC.Phys.ADS
uADPhysADSCli -> FireDAC.Phys.ADSCli
uADPhysADSMeta -> FireDAC.Phys.ADSMeta
uADPhysADSWrapper -> FireDAC.Phys.ADSWrapper
uADPhysASA -> FireDAC.Phys.ASA
uADPhysASACli -> FireDAC.Phys.ASACli
uADPhysASAMeta -> FireDAC.Phys.ASAMeta
uADPhysASAWrapper -> FireDAC.Phys.ASAWrapper
uADPhysCmdGenerator -> FireDAC.Phys.SQLGenerator
uADPhysCmdPreprocessor -> FireDAC.Phys.SQLPreprocessor
uADPhysConnMeta -> FireDAC.Phys.Meta
uADPhysDataSnap -> FireDAC.Phys.DS
uADPhysDataSnapMeta -> FireDAC.Phys.DSMeta
uADPhysDataSnapProxyCpp -> FireDAC.Phys.DSProxyCpp
uADPhysDataSnapProxyDelphi -> FireDAC.Phys.DSProxyDelphi
uADPhysDB2 -> FireDAC.Phys.DB2
uADPhysDB2Meta -> FireDAC.Phys.DB2Meta
uADPhysDBExp -> FireDAC.Phys.DBX
uADPhysDBExpMeta -> FireDAC.Phys.DBXMeta
uADPhysDBExpReg -> FireDAC.Phys.DBXReg
uADPhysFB -> FireDAC.Phys.FB
uADPhysIB -> FireDAC.Phys.IB
uADPhysIBBase -> FireDAC.Phys.IBBase
uADPhysIBCli -> FireDAC.Phys.IBCli
uADPhysIBMeta -> FireDAC.Phys.IBMeta
uADPhysIBWrapper -> FireDAC.Phys.IBWrapper
uADPhysIntf -> FireDAC.Phys.Intf
uADPhysManager -> FireDAC.Phys
uADPhysMSAcc -> FireDAC.Phys.MSAcc
uADPhysMSAccMeta -> FireDAC.Phys.MSAccMeta
uADPhysMSSQL -> FireDAC.Phys.MSSQL
uADPhysMSSQLMeta -> FireDAC.Phys.MSSQLMeta
uADPhysMySQL -> FireDAC.Phys.MySQL
uADPhysMySQLCli -> FireDAC.Phys.MySQLCli
uADPhysMySQLMeta -> FireDAC.Phys.MySQLMeta
uADPhysMySQLWrapper -> FireDAC.Phys.MySQLWrapper
uADPhysNexus -> FireDAC.Phys.Nexus
uADPhysNexusMeta -> FireDAC.Phys.NexusMeta
uADPhysODBC -> FireDAC.Phys.ODBC
uADPhysODBCBase -> FireDAC.Phys.ODBCBase
uADPhysODBCCli -> FireDAC.Phys.ODBCCli
uADPhysODBCMeta -> FireDAC.Phys.ODBCMeta
uADPhysODBCWrapper -> FireDAC.Phys.ODBCWrapper
uADPhysOracle -> FireDAC.Phys.Oracle
uADPhysOracleCli -> FireDAC.Phys.OracleCli
uADPhysOracleMeta -> FireDAC.Phys.OracleMeta
uADPhysOracleWrapper -> FireDAC.Phys.OracleWrapper
uADPhysPG -> FireDAC.Phys.PG
uADPhysPGCli -> FireDAC.Phys.PGCli
uADPhysPGMeta -> FireDAC.Phys.PGMeta
uADPhysPGWrapper -> FireDAC.Phys.PGWrapper
uADPhysSQLite -> FireDAC.Phys.SQLite
uADPhysSQLiteCli -> FireDAC.Phys.SQLiteCli
uADPhysSQLiteMeta -> FireDAC.Phys.SQLiteMeta
uADPhysSQLiteWrapper -> FireDAC.Phys.SQLiteWrapper
uADPhysSQLiteVDataSet -> FireDAC.Phys.SQLiteVDataSet
uADPhysTDBX -> FireDAC.Phys.TDBX
uADPhysTDBXBase -> FireDAC.Phys.TDBXBase
uADPhysTDBXMeta -> FireDAC.Phys.TDBXMeta

uADSQLiteIniFile -> FireDAC.Phys.SQLiteIniFile
uADCompVSE -> FireDAC.Comp.VSE
uADCompVSEXML -> FireDAC.Comp.VSEXML

